
C 225,30,0

EA textures/GOOBRICKS.png

SO textures/CASTLEBRICKS.png
WE textures/DUNGEONBRICKS.png
NO textures/BIGBRICKS.png
F 220,100,119 

    1111111111111111111111111
    1000000000110000000000001
    1011000001110000000011111
1111100000000000000000001
111111111011000001110000111111111
1N0000000011000001110111111111111
11110111111111011100000010001
11110111111111011101010010001
11000000110101011100000010001
10000000000000001100000010001
10000000010000001101010010001
1100000111010101111101111000111
11110111 1110101 101111010001
11111111 1111111 111111111111
